111111111111111111
10P001000010000001
100011100001100001
100010100000000001
10E0101000C0110001
100000000000000001
111111111111111111