111111111111111111
10P001C00110000C01
100011110001100101
100010100000000001
10E0101000C0110001
100000000000000001
111111111111111111