1111111111111
101C000000001
1010010101001
1000100100001
1111111011101
1000000000001
1111111111111