0P1E000000000
001C010101000
0000100100000
0111111011100
0000000000000