11111111111111111111111
1XCCC0CCCCC1CCCCC0CCCX1
10111011110101111011101
10111011110101111011101
10000000000P00000000001
10111010111111101011101
10CCC01CCCCECCCC10CCC01
11111X10111111101X11111
1CCCC0CCCCCCCCCCC0CCCC1
10111011110101111011101
10001000000000000010001
11101010111111101010111
1CCCC0100001000010CCCC1
1C1111111101011111111C1
1CCCCCCCCCCCCCCCCCCCCC1
11111111111111111111111