111111111111111
1E000000C00X0X1
100010001010101
101010101010101
1P0C00C00X000C1
111111111111111