





11111111111111
10000000000001
1S000000000001
1000000P000001
10E00000000001
11111111111111