111111111111111
1E000C100001C01
100011100001101
1000101P0000001
100110100000001
10C000000000001
111111111111111