111111111111111
1E000000CX0X0X1
1000100010101C1
1010101010101C1
1P0C00C000000C1
111111111111111