111111111111111
1E000000C000001
100010001010101
101010101010101
1P0C00C000000C1
111111111111111