1111111111111
1P1E0000000C1
1010010101001
10001C01C0001
1111111C11101
1C00000000001
1111111111111